11111111
10000001
11011101
1P001001
1E110101
10010001
10000001
11111111