11111111
1P0000E1
11110111
1C110001
11110111
10000001
10000001
11111111