11111111
1P0000E1
10000001
1C000001
1111111
11111111
11111111
11111111