11111111
1P0000E1
10000001
1C000001
10000001
10000001
10000001
11011111