11111111
1P0000E1
1P000001
10000001
10C00001
10000001
10000001
11111111