11111111
1P0100E1
10110011
10C01001
10111001
101C0001
10000001
11111111