11111111
1P0101E1
10110111
10C01001
10111001
101C0001
10000001
11111111