11111111
10000001
1P1110C1
10001011
1C011001
110000E1
1C010001
11111111
