11111111
1E0000C1
10111001
1C100001
101P1101
100010C1
10001001
11111111