11111111
1C000001
11011101
1P001C01
1E110101
10010001
1C000001
11111111