11111111
10000C01
10111001
1C000001
111P1101
10101E01
1C000001
11111111